1111111111
1P00000C01
10000C0001
10C00000E1
1111111111
