111111111
1P0000C01
10C0000E1
111111111
