111111111
1P0000C11
10C0000E1
111111111
