111111111
1P0000C11
10C0001E1
111111111
