1111111111111
10010000000C1
1C00011111001
100011E00P000
1111111111111